1111111111
1000000001
1011001101
1011001101
1000110001
1001111001
1001111001
1001001001
1000000001
1111111111