0000000110
0001111001
0011111001
0011101111
0111110100
0111110100
0111111110
1000000010
1000000010
0111111100