0000000000
0000111110
0001111110
0001000010
0001000010
0001000010
0001001110
0111001110
0111000000
0000000000