0000100000
0001010000
0001010000
0010001000
0011111000
0010001000
0101010100
0101010100
1000100010
1111111110