00000000000000110000
00000000000011001000
00000000000100001000
00000000011000010000
00000001100000010000
01111110000000100000
10000000000000100000
01000000000000100000
00111000000001000000
00000111000000100000
00001011111000010000
00011011011110001000
00101111011110100100
01011111111111011000
01000111000000010000
01100000011100100000
10010001100000010000
10010011100000010000
01100100100000010000
01010100100000010000
01010011100000100000
01001000010000100000
01000100010000110000
11000011001001011000
01111111111111110000